"filename", "language", "Markdown", "C++", "Makefile", "comment", "blank", "total"
"/home/x2y/workspace/github/UDSSE/README.md", "Markdown", 7, 0, 0, 5, 8, 20
"/home/x2y/workspace/github/UDSSE/code/BloomFilter.cpp", "C++", 0, 87, 0, 13, 7, 107
"/home/x2y/workspace/github/UDSSE/code/BloomFilter.h", "C++", 0, 56, 0, 16, 7, 79
"/home/x2y/workspace/github/UDSSE/code/CS.cpp", "C++", 0, 147, 0, 47, 21, 215
"/home/x2y/workspace/github/UDSSE/code/CS.h", "C++", 0, 35, 0, 5, 5, 45
"/home/x2y/workspace/github/UDSSE/code/Makefile", "Makefile", 0, 0, 42, 1, 4, 47
"/home/x2y/workspace/github/UDSSE/code/PRF.cpp", "C++", 0, 114, 0, 7, 11, 132
"/home/x2y/workspace/github/UDSSE/code/PRF.h", "C++", 0, 22, 0, 9, 6, 37
"/home/x2y/workspace/github/UDSSE/code/RSA.cpp", "C++", 0, 257, 0, 71, 45, 373
"/home/x2y/workspace/github/UDSSE/code/RSA.h", "C++", 0, 19, 0, 10, 10, 39
"/home/x2y/workspace/github/UDSSE/code/SRE.cpp", "C++", 0, 45, 0, 21, 5, 71
"/home/x2y/workspace/github/UDSSE/code/SRE.h", "C++", 0, 64, 0, 15, 3, 82
"/home/x2y/workspace/github/UDSSE/code/UDSSE.cpp", "C++", 0, 891, 0, 97, 130, 1118
"/home/x2y/workspace/github/UDSSE/code/UDSSE.h", "C++", 0, 104, 0, 37, 25, 166
"/home/x2y/workspace/github/UDSSE/code/UPE.cpp", "C++", 0, 487, 0, 82, 72, 641
"/home/x2y/workspace/github/UDSSE/code/UPE.h", "C++", 0, 192, 0, 5, 18, 215
"/home/x2y/workspace/github/UDSSE/code/back/UDSSE.cpp", "C++", 0, 141, 0, 31, 36, 208
"/home/x2y/workspace/github/UDSSE/code/back/UDSSE.h", "C++", 0, 66, 0, 11, 16, 93
"/home/x2y/workspace/github/UDSSE/code/test.cpp", "C++", 0, 29, 0, 5, 1, 35
"/home/x2y/workspace/github/UDSSE/code/testClient.cpp", "C++", 0, 12, 0, 5, 4, 21
"/home/x2y/workspace/github/UDSSE/code/testRSA.cpp", "C++", 0, 11, 0, 5, 0, 16
"/home/x2y/workspace/github/UDSSE/code/testSRE.cpp", "C++", 0, 72, 0, 14, 12, 98
"/home/x2y/workspace/github/UDSSE/code/testServer.cpp", "C++", 0, 7, 0, 5, 4, 16
"/home/x2y/workspace/github/UDSSE/code/testUDSSE.cpp", "C++", 0, 61, 0, 18, 18, 97
"/home/x2y/workspace/github/UDSSE/code/testUPE.cpp", "C++", 0, 388, 0, 55, 32, 475
"Total", "-", 7, 3307, 42, 590, 500, 4446